WE ./src/textures/west.png
SO ./src/textures/south.png
NO ./src/textures/north.png
EA ./src/textures/east.png

C 10,10,250
F 90,90,255


11111111111111111111111111
10000000010000000000000001
10000000010000000000000101
10000000011110000000100001
10000000000000100000000001
10000000000N00100000000001
10000000000000100000000001
10000000000100111111111111
10010000000100000000000001
11110000000100000000101011
11111111111111111111111111
